ijkID	vragenReeks	geslaagd	totaalJuist	totaalFout	totaalBlanco	totaalScore	wiskunde_basisJuist	wiskunde_basisFout	wiskunde_basisBlanco	wiskunde_basisScore	wiskunde_standaardJuist	wiskunde_standaardFout	wiskunde_standaardBlanco	wiskunde_standaardScore
q1388897	1	1	15	5	5	11	8	1	1	8	7	4	4	6
q1392620	1	1	20	2	3	15	10	0	0	10	10	2	3	9
q1392111	1	1	18	3	4	14	9	1	0	9	9	2	4	8
q1426071	1	0	6	19	0	0	2	8	0	0	4	11	0	0
q1396695	1	0	12	3	10	9	6	3	1	5	6	0	9	6
q1111298	1	1	18	3	4	14	9	0	1	9	9	3	3	8
q1446588	1	1	15	4	6	11	7	2	1	6	8	2	5	7
q1423205	1	1	14	4	7	10	8	2	0	7	6	2	7	5
q1394107	1	1	18	3	4	14	10	0	0	10	8	3	4	7
q1360712	1	1	22	0	3	18	10	0	0	10	12	0	3	12
q1446321	1	0	15	10	0	9	6	4	0	5	9	6	0	7
q1426690	1	1	20	3	2	15	9	1	0	9	11	2	2	10
q1446123	1	1	14	1	10	11	7	0	3	7	7	1	7	7
q1431488	1	1	18	4	3	13	10	0	0	10	8	4	3	7
q1247332	1	1	23	2	0	18	10	0	0	10	13	2	0	12
q1462294	1	0	14	7	4	9	7	1	2	7	7	6	2	5
q1342814	1	1	21	1	3	17	9	0	1	9	12	1	2	12
q1409484	1	0	11	8	6	7	7	2	1	6	4	6	5	2
q1311763	1	1	23	2	0	18	10	0	0	10	13	2	0	12
q1238490	1	1	17	8	0	11	9	1	0	9	8	7	0	6
q1418758	1	1	19	4	2	14	8	2	0	7	11	2	2	10
q1459610	1	1	24	1	0	19	10	0	0	10	14	1	0	14
q1438426	1	1	18	3	4	14	8	2	0	7	10	1	4	10
q1381103	1	1	21	3	1	16	10	0	0	10	11	3	1	10
q1422975	1	1	20	4	1	15	10	0	0	10	10	4	1	9
q1393504	1	1	23	2	0	18	9	1	0	9	14	1	0	14
q1421294	1	1	20	4	1	15	10	0	0	10	10	4	1	9
q1381527	1	1	25	0	0	20	10	0	0	10	15	0	0	15
q1403174	1	1	18	4	3	13	9	1	0	9	9	3	3	8
q1456456	1	1	23	2	0	18	10	0	0	10	13	2	0	12
q1417536	1	0	13	12	0	7	6	4	0	5	7	8	0	4
q1444627	1	1	17	5	3	12	9	1	0	9	8	4	3	7
q1426868	1	1	20	0	5	16	10	0	0	10	10	0	5	10
q1240459	1	1	22	2	1	17	10	0	0	10	12	2	1	11
q1441009	1	1	23	1	1	18	10	0	0	10	13	1	1	13
q1417696	1	1	21	2	2	16	8	1	1	8	13	1	1	13
q1394613	1	1	19	5	1	14	10	0	0	10	9	5	1	7
q1445983	1	0	12	8	5	7	6	3	1	5	6	5	4	4
q1433956	1	1	17	4	4	13	10	0	0	10	7	4	4	6
q1417881	1	1	22	3	0	17	8	2	0	7	14	1	0	14
q1419052	1	1	22	3	0	17	10	0	0	10	12	3	0	11
q1431164	1	1	20	3	2	15	8	1	1	8	12	2	1	11
q1445836	1	1	16	6	3	11	8	2	0	7	8	4	3	7
q1392588	1	1	24	1	0	19	10	0	0	10	14	1	0	14
q1403194	1	1	17	5	3	12	10	0	0	10	7	5	3	5
q1375386	1	1	18	7	0	13	8	2	0	7	10	5	0	8
q1346786	1	1	25	0	0	20	10	0	0	10	15	0	0	15
q1422304	1	1	20	2	3	15	10	0	0	10	10	2	3	9
q1457307	1	0	12	7	6	8	7	2	1	6	5	5	5	3
q1415174	1	0	15	10	0	9	9	1	0	9	6	9	0	3
q1392579	1	1	16	4	5	12	8	1	1	8	8	3	4	7
q1438836	1	1	21	2	2	16	8	1	1	8	13	1	1	13
q1423900	1	1	20	1	4	16	9	1	0	9	11	0	4	11
q1458522	1	1	18	7	0	13	8	2	0	7	10	5	0	8
q1393513	1	1	16	6	3	11	9	1	0	9	7	5	3	5
q1421726	1	1	22	3	0	17	10	0	0	10	12	3	0	11
q1417905	1	1	23	2	0	18	10	0	0	10	13	2	0	12
q1244458	1	1	15	5	5	11	8	2	0	7	7	3	5	6
q1459993	1	0	13	7	5	9	8	2	0	7	5	5	5	3
q1393488	1	1	15	3	7	11	9	1	0	9	6	2	7	5
q1413820	1	1	21	4	0	16	9	1	0	9	12	3	0	11
q1418683	1	1	18	5	2	13	9	1	0	9	9	4	2	8
q1459988	1	1	16	5	4	11	8	2	0	7	8	3	4	7
q1393974	1	0	15	10	0	9	8	2	0	7	7	8	0	4
q1401337	1	1	19	3	3	14	10	0	0	10	9	3	3	8
q1409706	1	1	18	3	4	14	9	1	0	9	9	2	4	8
q1401118	1	1	14	4	7	10	7	2	1	6	7	2	6	6
q1444297	1	1	23	2	0	18	10	0	0	10	13	2	0	12
q1396707	1	1	23	2	0	18	9	1	0	9	14	1	0	14
q1380369	1	1	17	6	2	12	10	0	0	10	7	6	2	5
q1421488	1	0	12	3	10	9	7	2	1	6	5	1	9	5
q1457671	1	0	10	15	0	4	5	5	0	3	5	10	0	2
q1393489	1	1	22	3	0	17	10	0	0	10	12	3	0	11
q1383917	1	1	17	2	6	13	9	1	0	9	8	1	6	8
q1382698	1	1	21	1	3	17	10	0	0	10	11	1	3	11
q1435490	1	1	23	1	1	18	10	0	0	10	13	1	1	13
q1445971	1	1	15	9	1	10	9	1	0	9	6	8	1	3
q1457003	1	1	21	3	1	16	10	0	0	10	11	3	1	10
q1459994	1	1	21	1	3	17	9	0	1	9	12	1	2	12
q1444443	1	1	18	5	2	13	10	0	0	10	8	5	2	6
q1403177	1	1	18	2	5	14	8	1	1	8	10	1	4	10
q1455825	1	1	14	3	8	10	7	1	2	7	7	2	6	6
q1422051	1	1	21	0	4	17	10	0	0	10	11	0	4	11
q1422805	1	1	21	4	0	16	10	0	0	10	11	4	0	10
q1463999	1	1	19	0	6	15	10	0	0	10	9	0	6	9
q1377833	1	1	17	4	4	13	9	1	0	9	8	3	4	7
q1455826	1	1	21	3	1	16	10	0	0	10	11	3	1	10
q1379645	1	1	16	4	5	12	10	0	0	10	6	4	5	5
q1422422	1	1	23	2	0	18	10	0	0	10	13	2	0	12
q1445978	1	1	24	1	0	19	9	1	0	9	15	0	0	15
q1421352	1	1	20	5	0	15	8	2	0	7	12	3	0	11
q1441649	1	1	19	4	2	14	8	2	0	7	11	2	2	10
q1342178	1	1	16	4	5	12	8	1	1	8	8	3	4	7
q1317863	1	1	20	3	2	15	10	0	0	10	10	3	2	9
q1393837	1	1	20	1	4	16	9	0	1	9	11	1	3	11
q1384709	1	1	24	0	1	19	10	0	0	10	14	0	1	14
q1441295	1	1	17	8	0	11	10	0	0	10	7	8	0	4
q1393457	1	1	20	2	3	15	10	0	0	10	10	2	3	9
q1384003	1	1	22	3	0	17	10	0	0	10	12	3	0	11
q1393846	1	1	20	4	1	15	10	0	0	10	10	4	1	9
q1393864	1	1	22	2	1	17	10	0	0	10	12	2	1	11
q1423179	1	1	18	3	4	14	9	0	1	9	9	3	3	8
q1393843	1	1	21	3	1	16	10	0	0	10	11	3	1	10
q1422307	1	1	21	2	2	16	9	1	0	9	12	1	2	12
q1393606	1	1	21	4	0	16	9	1	0	9	12	3	0	11
q1394236	1	1	22	3	0	17	9	1	0	9	13	2	0	12
q1457881	1	1	20	3	2	15	10	0	0	10	10	3	2	9
q1392594	1	1	20	5	0	15	7	3	0	6	13	2	0	12
q1393870	1	1	22	3	0	17	9	1	0	9	13	2	0	12
q1418129	1	1	21	4	0	16	9	1	0	9	12	3	0	11
q1458284	1	0	11	4	10	8	7	1	2	7	4	3	8	3
q1424627	1	1	15	5	5	11	10	0	0	10	5	5	5	3
q1414181	1	0	13	9	3	8	6	3	1	5	7	6	2	5
q1423230	1	1	20	4	1	15	9	0	1	9	11	4	0	10
q1389591	1	1	22	3	0	17	10	0	0	10	12	3	0	11
q1429103	1	1	21	2	2	16	10	0	0	10	11	2	2	10
q1419299	1	1	20	2	3	15	10	0	0	10	10	2	3	9
q1445131	1	1	23	2	0	18	10	0	0	10	13	2	0	12
q1458288	1	1	21	3	1	16	10	0	0	10	11	3	1	10
q1381668	1	1	18	4	3	13	9	0	1	9	9	4	2	8
q1369421	1	1	15	7	3	10	8	2	0	7	7	5	3	5
q1417067	1	1	18	3	4	14	9	1	0	9	9	2	4	8
q1396638	1	1	20	3	2	15	9	0	1	9	11	3	1	10
q1421200	1	1	15	7	3	10	8	2	0	7	7	5	3	5
q1341923	1	1	24	1	0	19	10	0	0	10	14	1	0	14
q1396595	1	1	19	6	0	14	10	0	0	10	9	6	0	7
q1314680	1	1	16	1	8	13	9	0	1	9	7	1	7	7
q1458350	1	1	18	4	3	13	9	1	0	9	9	3	3	8
q1427407	1	1	22	1	2	17	10	0	0	10	12	1	2	12
q0452728	1	1	22	3	0	17	10	0	0	10	12	3	0	11
q1396625	1	1	23	2	0	18	10	0	0	10	13	2	0	12
q1457668	1	1	22	2	1	17	9	1	0	9	13	1	1	13
q1383639	1	1	24	1	0	19	10	0	0	10	14	1	0	14
q1396631	1	1	15	5	5	11	6	3	1	5	9	2	4	8
q1396612	1	1	15	7	3	10	8	2	0	7	7	5	3	5
q1388871	1	1	17	3	5	13	8	1	1	8	9	2	4	8
q1393193	1	1	24	1	0	19	10	0	0	10	14	1	0	14
q1350794	1	1	25	0	0	20	10	0	0	10	15	0	0	15
q1340432	1	1	17	2	6	13	9	0	1	9	8	2	5	7
q1376377	1	1	17	2	6	13	9	0	1	9	8	2	5	7
q1390106	1	1	24	1	0	19	10	0	0	10	14	1	0	14
q1387472	1	1	19	1	5	15	10	0	0	10	9	1	5	9
q1417473	1	1	22	1	2	17	10	0	0	10	12	1	2	12
q1295193	1	1	20	5	0	15	9	1	0	9	11	4	0	10
q1348852	1	1	18	2	5	14	9	1	0	9	9	1	5	9
q1393771	1	1	22	1	2	17	10	0	0	10	12	1	2	12
q1461736	1	0	9	16	0	3	3	7	0	1	6	9	0	3
q1438425	1	1	18	3	4	14	8	1	1	8	10	2	3	9
q1383948	1	0	10	6	9	6	5	3	2	4	5	3	7	4
q1402174	1	1	15	2	8	11	10	0	0	10	5	2	8	4
q1379657	1	1	23	2	0	18	10	0	0	10	13	2	0	12
q1380373	1	1	23	2	0	18	10	0	0	10	13	2	0	12
q1370159	1	1	20	5	0	15	9	1	0	9	11	4	0	10
q1379643	1	1	22	0	3	18	10	0	0	10	12	0	3	12
q1414665	1	1	24	0	1	19	10	0	0	10	14	0	1	14
q1382206	1	1	18	4	3	13	8	2	0	7	10	2	3	9
q1381703	1	0	13	8	4	8	8	1	1	8	5	7	3	3
q1230953	1	1	21	4	0	16	9	1	0	9	12	3	0	11
q1414086	1	1	22	2	1	17	10	0	0	10	12	2	1	11
q1426571	1	1	21	4	0	16	10	0	0	10	11	4	0	10
q1427325	1	1	20	4	1	15	8	2	0	7	12	2	1	11
q1326113	1	1	17	8	0	11	10	0	0	10	7	8	0	4
q1332540	1	1	21	2	2	16	10	0	0	10	11	2	2	10
J978772	1	0	12	8	5	7	8	2	0	7	4	6	5	2
q1377368	1	0	12	13	0	6	7	3	0	6	5	10	0	2
q1231332	1	1	23	2	0	18	10	0	0	10	13	2	0	12
q1330311	1	1	22	2	1	17	8	2	0	7	14	0	1	14
q1307903	1	1	22	2	1	17	10	0	0	10	12	2	1	11
q1462372	1	1	18	7	0	13	8	2	0	7	10	5	0	8
q1408491	1	1	17	2	6	13	8	1	1	8	9	1	5	9
q1413327	1	1	19	2	4	15	9	0	1	9	10	2	3	9
q1368828	1	1	15	5	5	11	10	0	0	10	5	5	5	3
q1446122	1	1	16	4	5	12	10	0	0	10	6	4	5	5
q1385954	1	1	18	7	0	13	9	1	0	9	9	6	0	7
q1310596	1	1	18	7	0	13	10	0	0	10	8	7	0	6
q1421894	1	1	22	2	1	17	9	0	1	9	13	2	0	12
q1345541	1	1	20	2	3	15	10	0	0	10	10	2	3	9
q1378090	1	1	20	3	2	15	10	0	0	10	10	3	2	9
q1375105	1	1	25	0	0	20	10	0	0	10	15	0	0	15
q1344034	1	1	25	0	0	20	10	0	0	10	15	0	0	15
q1396310	1	1	25	0	0	20	10	0	0	10	15	0	0	15
q1400281	1	1	17	5	3	12	7	2	1	6	10	3	2	9
q1361270	1	1	17	3	5	13	8	1	1	8	9	2	4	8
J978759	1	1	17	5	3	12	7	2	1	6	10	3	2	9
q1387459	1	1	19	2	4	15	10	0	0	10	9	2	4	8
q1366488	1	1	24	1	0	19	9	1	0	9	15	0	0	15
q1378075	1	1	23	0	2	18	10	0	0	10	13	0	2	13
q1381559	1	1	14	2	9	11	10	0	0	10	4	2	9	3
q1386254	1	1	20	2	3	15	9	1	0	9	11	1	3	11
q1379573	1	1	16	2	7	12	10	0	0	10	6	2	7	5
J978756	1	1	18	1	6	14	10	0	0	10	8	1	6	8
q1413720	1	0	13	6	6	9	9	1	0	9	4	5	6	2
q1310223	1	0	12	10	3	7	7	2	1	6	5	8	2	2
q1420208	1	1	22	0	3	18	10	0	0	10	12	0	3	12
q1386250	1	1	20	2	3	15	10	0	0	10	10	2	3	9
q1381225	1	1	21	3	1	16	10	0	0	10	11	3	1	10
q1353686	1	1	17	6	2	12	9	1	0	9	8	5	2	6
q1343695	1	1	19	6	0	14	10	0	0	10	9	6	0	7
J978755	1	1	22	3	0	17	10	0	0	10	12	3	0	11
J978754	1	1	19	3	3	14	9	1	0	9	10	2	3	9
J978753	1	1	20	4	1	15	9	1	0	9	11	3	1	10
q1346592	1	1	25	0	0	20	10	0	0	10	15	0	0	15
J978752	1	1	22	2	1	17	9	0	1	9	13	2	0	12
q1376972	1	1	21	3	1	16	9	1	0	9	12	2	1	11
q1395780	1	1	15	6	4	10	8	1	1	8	7	5	3	5
J978751	1	1	23	2	0	18	10	0	0	10	13	2	0	12
J978750	1	1	24	1	0	19	10	0	0	10	14	1	0	14
J978749	1	1	20	3	2	15	8	2	0	7	12	1	2	12
J978747	1	1	20	4	1	15	10	0	0	10	10	4	1	9
J978743	1	0	14	9	2	9	8	2	0	7	6	7	2	4
J978742	1	1	20	2	3	15	9	0	1	9	11	2	2	10
q1216554	1	1	21	2	2	16	10	0	0	10	11	2	2	10
q1166487	1	0	11	6	8	7	6	2	2	5	5	4	6	4
q1166482	1	0	11	4	10	8	6	2	2	5	5	2	8	4
q1166480	1	0	9	3	13	6	7	1	2	7	2	2	11	1
q1218189	1	1	14	4	7	10	8	2	0	7	6	2	7	5
q0925743	1	1	18	1	6	14	9	0	1	9	9	1	5	9
q1196439	1	0	12	7	6	8	8	1	1	8	4	6	5	2
q1139647	1	1	21	3	1	16	10	0	0	10	11	3	1	10
q1165495	1	1	18	4	3	13	8	2	0	7	10	2	3	9
q1145674	1	1	18	5	2	13	10	0	0	10	8	5	2	6
q0902511	1	1	21	2	2	16	10	0	0	10	11	2	2	10
q1165048	1	1	16	6	3	11	10	0	0	10	6	6	3	4
q1178443	1	1	16	3	6	12	9	1	0	9	7	2	6	6
q0978105	1	1	14	5	6	10	8	2	0	7	6	3	6	5
q1098280	1	1	14	5	6	10	8	2	0	7	6	3	6	5
q1156137	1	1	15	5	5	11	8	1	1	8	7	4	4	6
q1156136	1	1	13	1	11	10	7	0	3	7	6	1	8	6
q0975127	1	1	18	1	6	14	10	0	0	10	8	1	6	8
q1205122	1	1	18	1	6	14	10	0	0	10	8	1	6	8
q1165049	1	1	21	2	2	16	10	0	0	10	11	2	2	10
q1165056	1	1	21	2	2	16	10	0	0	10	11	2	2	10
q1142335	1	1	21	2	2	16	10	0	0	10	11	2	2	10
q1165044	1	1	21	2	2	16	10	0	0	10	11	2	2	10
q1192934	1	1	17	8	0	11	9	1	0	9	8	7	0	6
q1150416	1	1	18	5	2	13	10	0	0	10	8	5	2	6
q1166330	1	0	10	13	2	5	5	4	1	4	5	9	1	2
q1166337	1	1	23	2	0	18	10	0	0	10	13	2	0	12
q1143814	1	1	22	2	1	17	10	0	0	10	12	2	1	11
q1178275	1	1	19	5	1	14	10	0	0	10	9	5	1	7
q0976716	1	1	17	4	4	13	9	0	1	9	8	4	3	7
q1178673	1	1	17	4	4	13	9	0	1	9	8	4	3	7
q1165051	1	1	16	9	0	10	8	2	0	7	8	7	0	6
q1146436	1	1	16	2	7	12	9	0	1	9	7	2	6	6
q1180329	1	0	13	6	6	9	6	3	1	5	7	3	5	6
q1203303	1	0	5	9	11	2	4	2	4	3	1	7	7	0
q1196674	1	1	20	1	4	16	9	1	0	9	11	0	4	11
q1178272	1	1	19	2	4	15	10	0	0	10	9	2	4	8
q1220593	1	1	19	2	4	15	8	2	0	7	11	0	4	11
q1006359	1	1	20	5	0	15	9	1	0	9	11	4	0	10
q1167840	1	1	19	2	4	15	9	0	1	9	10	2	3	9
q1156194	1	1	14	4	7	10	8	1	1	8	6	3	6	5
q1218617	1	1	15	1	9	12	10	0	0	10	5	1	9	5
q1171007	1	0	9	4	12	6	5	3	2	4	4	1	10	4
q1166089	1	0	9	8	8	5	6	3	1	5	3	5	7	1
q1178271	1	0	14	11	0	8	7	3	0	6	7	8	0	4
q1152913	1	0	15	10	0	9	8	2	0	7	7	8	0	4
q1178646	1	0	6	2	17	4	4	1	5	4	2	1	12	2
q1391930	1	1	23	2	0	18	10	0	0	10	13	2	0	12
q1446121	1	1	23	2	0	18	9	1	0	9	14	1	0	14
q1422987	1	0	14	7	4	9	9	1	0	9	5	6	4	3
q1320662	1	0	11	0	14	9	10	0	0	10	1	0	14	1
q1444309	1	1	20	3	2	15	9	1	0	9	11	2	2	10
q1417794	1	1	21	1	3	17	9	0	1	9	12	1	2	12
q1415455	1	1	16	5	4	11	9	1	0	9	7	4	4	6
q1440090	1	1	17	1	7	13	10	0	0	10	7	1	7	7
q1422282	1	0	13	12	0	7	8	2	0	7	5	10	0	2
q1422806	1	1	21	2	2	16	10	0	0	10	11	2	2	10
q1418166	1	1	21	1	3	17	9	0	1	9	12	1	2	12
q1379769	1	1	15	3	7	11	8	1	1	8	7	2	6	6
q1391922	1	1	22	2	1	17	10	0	0	10	12	2	1	11
q1391951	1	1	24	1	0	19	10	0	0	10	14	1	0	14
q1459279	1	1	15	1	9	12	9	0	1	9	6	1	8	6
q1417091	1	1	15	6	4	10	9	1	0	9	6	5	4	4
q1238811	1	0	12	6	7	8	6	3	1	5	6	3	6	5
q1391959	1	1	24	1	0	19	10	0	0	10	14	1	0	14
q1384656	1	1	18	1	6	14	10	0	0	10	8	1	6	8
q1391955	1	1	21	4	0	16	10	0	0	10	11	4	0	10
q1356087	1	1	17	6	2	12	8	2	0	7	9	4	2	8
q1417033	1	1	21	4	0	16	10	0	0	10	11	4	0	10
q1421724	1	0	0	3	22	0	0	3	7	0	0	0	15	0
q1401104	1	0	14	8	3	9	8	2	0	7	6	6	3	4
q1459277	1	1	20	3	2	15	10	0	0	10	10	3	2	9
q1382041	1	1	24	1	0	19	10	0	0	10	14	1	0	14
q1456466	1	1	18	4	3	13	9	1	0	9	9	3	3	8
q1457691	1	1	21	2	2	16	10	0	0	10	11	2	2	10
q1391964	1	1	22	1	2	17	10	0	0	10	12	1	2	12
q1403046	1	1	18	7	0	13	9	1	0	9	9	6	0	7
q1382631	1	1	24	1	0	19	10	0	0	10	14	1	0	14
q1390780	1	1	21	1	3	17	10	0	0	10	11	1	3	11
q1381683	1	1	22	3	0	17	10	0	0	10	12	3	0	11
q1421329	1	1	21	4	0	16	10	0	0	10	11	4	0	10
q1391921	1	1	19	2	4	15	10	0	0	10	9	2	4	8
q1391965	1	1	20	4	1	15	10	0	0	10	10	4	1	9
q1391826	1	1	20	5	0	15	9	1	0	9	11	4	0	10
q1444545	1	1	18	2	5	14	10	0	0	10	8	2	5	7
q1391744	1	1	22	2	1	17	9	1	0	9	13	1	1	13
q1363295	1	1	20	3	2	15	10	0	0	10	10	3	2	9
q1342412	1	1	24	1	0	19	9	1	0	9	15	0	0	15
q1341100	1	1	20	2	3	15	9	1	0	9	11	1	3	11
q1346637	1	1	20	5	0	15	10	0	0	10	10	5	0	8
q1422794	1	1	20	2	3	15	8	2	0	7	12	0	3	12
q1443216	1	1	21	4	0	16	10	0	0	10	11	4	0	10
q1345534	1	1	22	3	0	17	9	1	0	9	13	2	0	12
q1342739	1	1	21	1	3	17	10	0	0	10	11	1	3	11
q1363824	1	0	13	12	0	7	7	3	0	6	6	9	0	3
q1407781	1	1	20	2	3	15	10	0	0	10	10	2	3	9
q1458306	1	0	14	8	3	9	10	0	0	10	4	8	3	1
q1458963	1	0	15	10	0	9	10	0	0	10	5	10	0	2
q1417869	1	0	15	10	0	9	10	0	0	10	5	10	0	2
q1379583	1	1	18	6	1	13	10	0	0	10	8	6	1	6
q1455819	1	0	10	12	3	5	8	2	0	7	2	10	3	0
q1391908	1	1	23	2	0	18	10	0	0	10	13	2	0	12
q1400822	1	1	24	1	0	19	10	0	0	10	14	1	0	14
q1390771	1	1	17	1	7	13	8	0	2	8	9	1	5	9
q1382215	1	1	16	4	5	12	9	0	1	9	7	4	4	6
q1392361	1	0	14	11	0	8	6	4	0	5	8	7	0	6
q1442399	1	1	20	4	1	15	9	1	0	9	11	3	1	10
q0826738	1	0	1	3	21	0	1	3	6	0	0	0	15	0
r0843765	1	1	21	4	0	16	10	0	0	10	11	4	0	10
r0798734	1	0	13	4	8	9	9	0	1	9	4	4	7	3
r0845604	1	1	14	6	5	10	9	1	0	9	5	5	5	3
r0840924	1	1	22	3	0	17	10	0	0	10	12	3	0	11
r0840107	1	0	11	3	11	8	7	1	2	7	4	2	9	3
r0837942	1	1	18	4	3	13	9	1	0	9	9	3	3	8
r0839486	1	0	13	8	4	8	8	2	0	7	5	6	4	3
r0840752	1	1	19	2	4	15	10	0	0	10	9	2	4	8
r0834595	1	1	15	5	5	11	9	1	0	9	6	4	5	5
r0708074	1	0	13	6	6	9	8	2	0	7	5	4	6	4
r0839582	1	0	11	14	0	5	6	4	0	5	5	10	0	2
r0857469	1	1	14	4	7	10	9	1	0	9	5	3	7	4
r0811286	1	1	18	2	5	14	9	1	0	9	9	1	5	9
r0855741	1	0	15	10	0	9	8	2	0	7	7	8	0	4
r0837941	1	1	20	4	1	15	10	0	0	10	10	4	1	9
r0856174	1	1	20	3	2	15	10	0	0	10	10	3	2	9
r0825085	1	1	14	6	5	10	6	3	1	5	8	3	4	7
r0843758	1	1	21	3	1	16	10	0	0	10	11	3	1	10
r0834784	1	1	19	4	2	14	9	1	0	9	10	3	2	9
r0856154	1	1	21	1	3	17	10	0	0	10	11	1	3	11
r0848649	1	0	13	5	7	9	9	0	1	9	4	5	6	2
r0850169	1	1	21	2	2	16	10	0	0	10	11	2	2	10
r0849682	1	1	24	0	1	19	10	0	0	10	14	0	1	14
r0848650	1	1	21	2	2	16	9	1	0	9	12	1	2	12
r0837927	1	1	15	5	5	11	8	1	1	8	7	4	4	6
r0892869	1	1	19	1	5	15	10	0	0	10	9	1	5	9
r0842847	1	1	20	3	2	15	10	0	0	10	10	3	2	9
r0853423	1	0	13	12	0	7	5	5	0	3	8	7	0	6
r0837928	1	1	20	3	2	15	9	1	0	9	11	2	2	10
r0835818	1	1	19	4	2	14	10	0	0	10	9	4	2	8
r0837937	1	1	17	4	4	13	9	0	1	9	8	4	3	7
r0855872	1	1	18	4	3	13	9	0	1	9	9	4	2	8
r0849675	1	1	18	6	1	13	10	0	0	10	8	6	1	6
r0849684	1	0	14	7	4	9	6	3	1	5	8	4	3	7
r0837443	1	1	22	3	0	17	10	0	0	10	12	3	0	11
r0837441	1	1	23	0	2	18	10	0	0	10	13	0	2	13
r0850724	1	0	10	9	6	6	8	1	1	8	2	8	5	0
r0853864	1	1	14	6	5	10	7	2	1	6	7	4	4	6
